縣市代碼,縣市名稱,學校代碼,學校名稱,專任教師數男,專任教師數女,兼任教師數男,兼任教師數女,職員數男,職員數女,班級數,學生數男,學生數女,上學年畢業生數男,上學年畢業生數女,lat,lng,stu_sum,stu_sum_lastyear,staff_sum
30,臺北市,400144,國立臺灣戲曲學院附設高職,29,45,0,0,0,0,21,146,280,48,103,25.0819234,121.586525,426,151,74
14,臺東縣,140222,國立臺東專科學校附設高職,35,37,0,0,8,3,36,598,273,118,47,22.7579117,121.1243815,871,165,83
1,新北市,010301,國立華僑高級中等學校,49,87,6,4,7,19,48,654,866,215,276,25.0075,121.4477778,1520,491,172
1,新北市,011301,私立淡江高中,37,68,0,0,7,15,34,507,555,247,252,25.1762507,121.437164,1062,499,127
1,新北市,011302,私立康橋高中,22,26,0,0,1,3,18,400,361,105,137,24.9120394,121.4958652,761,242,52
1,新北市,011306,私立金陵女中,25,78,1,3,3,19,17,0,737,0,350,25.04299,121.466942,737,350,129
1,新北市,011307,新北市裕德高級中等學校,14,32,2,8,10,13,7,44,36,20,18,24.9830118,121.4394801,80,38,79
1,新北市,011309,財團法人南山高中,103,116,8,11,10,25,38,1031,684,391,242,25.0016594,121.5036507,1715,633,273
1,新北市,011310,財團法人恆毅高中,39,58,3,3,8,15,18,487,261,179,110,25.0366541,121.4537324,748,289,126
1,新北市,011311,私立聖心女中,12,40,0,0,2,13,9,0,335,0,127,25.13562,121.449122,335,127,67
1,新北市,011314,財團法人中華高中,18,15,9,6,3,6,16,363,70,176,40,24.975578,121.4374135,433,216,57
1,新北市,011315,私立東海高中,15,24,22,10,5,13,27,781,162,411,114,25.0647366,121.4788449,943,525,89
1,新北市,011316,私立格致高中,51,43,6,4,7,10,32,633,296,317,157,25.0738323,121.4886747,929,474,121
1,新北市,011317,私立醒吾高中,22,26,6,7,7,15,33,420,468,219,230,25.079564,121.395793,888,449,83
1,新北市,011318,私立徐匯高中,13,26,0,0,5,7,9,304,0,174,0,25.080107,121.480124,304,174,51
1,新北市,011322,財團法人崇光女中,15,66,0,0,1,12,13,0,500,0,261,24.971809,121.539078,500,261,94
1,新北市,011323,私立光仁高中,35,57,7,7,7,14,17,378,311,106,135,25.0183052,121.4764718,689,241,127
1,新北市,011324,私立竹林高中,66,78,1,7,4,17,30,553,424,207,246,24.9799565,121.5057743,977,453,173
1,新北市,011325,私立及人高中,14,16,0,0,0,5,6,119,74,71,50,24.966799,121.51489,193,121,35
1,新北市,011329,財團法人辭修高中,25,47,3,2,17,21,12,287,179,139,92,24.932696,121.407931,466,231,115
1,新北市,011330,新北市林口康橋國際高中,24,31,1,0,24,27,10,123,122,0,0,25.0741868,121.389928,245,0,107
1,新北市,011399,私立時雨高中,51,31,0,0,11,18,15,373,240,138,80,25.1095045,121.8552909,613,218,111
1,新北市,013303,市立泰山高中,84,81,0,0,16,18,70,1783,624,367,180,25.057789,121.429729,2407,547,199
1,新北市,013304,市立板橋高中,51,92,13,16,2,19,60,1191,1146,376,380,25.012041,121.4590137,2337,756,193
1,新北市,013335,市立新店高中,38,88,6,7,2,17,51,945,965,306,320,24.975506,121.532082,1910,626,158
1,新北市,013336,市立中和高中,40,87,0,0,4,15,54,1171,892,287,297,24.994112,121.478471,2063,584,146
1,新北市,013337,市立新莊高中,55,80,3,5,4,14,57,1090,1057,340,327,22.6813675,120.3175826,2147,667,161
1,新北市,013338,市立新北高中,45,70,0,0,11,9,51,933,943,246,323,25.0874536,121.489796,1876,569,135
1,新北市,013339,市立林口高中,45,60,0,0,1,16,45,729,852,222,265,25.0732029,121.3805242,1581,487,122
1,新北市,014302,市立海山高中,81,194,0,0,5,19,33,665,553,190,218,25.0096689,121.4712073,1218,408,299
1,新北市,014311,市立三重高中,46,116,5,8,5,12,42,655,772,201,252,25.054741,121.4914967,1427,453,192
1,新北市,014315,市立永平高中,45,112,0,0,6,13,36,617,690,163,218,25.0105828,121.5083843,1307,381,176
1,新北市,014322,市立樹林高中,69,153,0,0,5,15,49,658,830,207,282,24.9829633,121.4223883,1488,489,242
1,新北市,014326,市立明德高中,66,88,2,10,7,15,36,625,567,128,195,24.9038379,121.365725,1192,323,188
1,新北市,014332,市立秀峰高中,59,112,0,0,4,12,33,453,536,130,157,25.0657829,121.6608704,989,287,187
1,新北市,014338,市立金山高中,37,59,0,0,4,9,18,223,253,75,77,25.224676,121.637008,476,152,109
1,新北市,014343,市立安康高中,47,99,0,0,5,13,33,502,553,173,173,24.9694528,121.5153,1055,346,164
1,新北市,014347,市立雙溪高中,29,37,0,0,4,10,15,164,135,42,62,25.0349052,121.8632554,299,104,80
1,新北市,014348,市立石碇高中,26,47,0,0,5,6,18,246,248,78,105,25.0141303,121.6429468,494,183,84
1,新北市,014353,市立丹鳳高中,74,152,0,0,6,13,30,537,543,163,176,25.021049,121.416544,1080,339,245
1,新北市,014356,市立清水高中,74,146,14,18,2,15,44,698,712,212,236,24.2652825,120.5740941,1410,448,269
1,新北市,014357,市立三民高中,64,152,19,23,1,18,46,753,765,222,269,25.0868693,121.4737065,1518,491,277
1,新北市,014362,市立錦和高中,50,131,6,14,4,12,33,569,539,161,182,24.992544,121.491084,1108,343,217
1,新北市,014363,市立光復高中,40,83,0,0,1,11,21,320,383,82,130,25.0167462,121.4822165,703,212,135
1,新北市,014364,市立竹圍高中,41,66,0,0,1,10,21,437,348,125,115,25.1459534,121.461587,785,240,118
1,新北市,014381,市立北大高級中學,24,50,0,0,2,7,18,363,347,104,105,24.948248,121.3764596,710,209,83
1,新北市,014399,市立豐珠中學,3,11,0,0,3,4,1,0,7,0,0,25.0656443,121.9018436,7,0,21
2,宜蘭縣,020301,國立蘭陽女中,39,58,0,0,2,17,42,0,1399,1,507,24.7453914,121.753373,1399,508,116
2,宜蘭縣,020302,國立宜蘭高中,62,46,2,3,7,13,44,1393,171,467,63,24.751424,121.7417203,1564,530,133
2,宜蘭縣,020308,國立羅東高中,37,61,0,0,7,11,42,685,730,207,293,24.6807286,121.761905,1415,500,116
2,宜蘭縣,021301,私立慧燈高中,50,48,0,0,14,14,20,522,281,183,116,24.777028,121.7155386,803,299,126
2,宜蘭縣,021310,私立中道高中,22,13,0,0,7,6,8,182,84,99,64,24.7597787,121.7937987,266,163,48
2,宜蘭縣,024322,縣立南澳高中,27,25,0,0,2,7,9,116,64,18,24,24.465902,121.801868,180,42,61
2,宜蘭縣,024325,縣立慈心華德福實中,13,17,0,0,5,9,3,40,58,11,17,24.6268113,121.795708,98,28,44
3,桃園市,030305,國立中央大學附屬中壢高中,64,81,20,32,4,19,60,1200,1090,407,360,24.962072,121.211168,2290,767,220
3,桃園市,031301,私立漢英高中,6,1,11,3,9,8,6,57,29,29,21,24.8481652,121.2453306,86,50,38
3,桃園市,031309,桃園市育達高中,69,112,10,30,11,16,146,2213,2931,853,1221,24.95191,121.209124,5144,2074,248
3,桃園市,031310,私立六和高中,46,81,0,0,8,15,30,671,443,278,161,24.9453453,121.1858942,1114,439,150
3,桃園市,031311,桃園市復旦高中,53,96,0,0,6,17,36,903,768,286,248,24.948372,121.203082,1671,534,172
3,桃園市,031312,桃園市治平高中,93,101,62,29,8,31,137,2969,2279,1095,966,24.9158677,121.1886835,5248,2061,324
3,桃園市,031313,桃園市振聲高中,66,101,16,10,4,23,72,1285,1932,456,622,24.9905152,121.3022615,3217,1078,220
3,桃園市,031317,私立光啟高中,22,33,3,3,3,9,32,854,237,492,161,25.0201005,121.4031147,1091,653,73
3,桃園市,031318,桃園市啟英高中,88,127,51,5,7,20,153,3378,2918,1178,1093,24.9750491,121.2357616,6296,2271,298
3,桃園市,031319,桃園市清華高中,18,5,5,5,6,8,25,328,109,180,45,24.9816339,121.1083826,437,225,47
3,桃園市,031320,桃園市新興高中,103,155,6,5,5,22,127,3417,2359,1308,988,24.975174,121.271855,5776,2296,296
3,桃園市,031323,私立至善高中,11,13,0,0,3,9,26,312,153,109,70,24.867158,121.284486,465,179,36
3,桃園市,031324,桃園市大興高中,47,39,0,0,4,6,52,1284,518,493,153,25.061988,121.192613,1802,646,96
3,桃園市,031326,私立大華高中,19,33,2,2,7,13,6,128,133,47,38,24.882732,121.1744393,261,85,76
3,桃園市,033302,市立龍潭高中,53,67,7,8,10,18,45,905,480,266,147,24.8612862,121.2129579,1385,413,163
3,桃園市,033304,市立桃園高中,65,99,1,5,5,21,66,1228,1228,390,426,24.9994003,121.3273196,2456,816,196
3,桃園市,033306,市立武陵高中,60,80,18,49,6,19,63,1347,1043,452,346,24.987672,121.2857263,2390,798,232
3,桃園市,033316,市立楊梅高中,56,67,5,1,6,18,49,989,662,244,199,24.921386,121.148215,1651,443,153
3,桃園市,033325,市立陽明高中,54,96,0,3,6,21,60,1105,1156,333,401,25.0922121,121.5172424,2261,734,180
3,桃園市,033327,市立內壢高中,46,79,0,1,6,17,57,1076,1087,335,372,24.9779218,121.2558058,2163,707,149
3,桃園市,034306,市立南崁高中,27,73,0,0,3,15,42,680,782,232,269,25.0524424,121.2970629,1462,501,118
3,桃園市,034312,市立大溪高中,36,48,1,3,3,12,33,602,515,154,204,24.868745,121.2858825,1117,358,103
3,桃園市,034314,市立壽山高中,65,78,0,0,4,17,54,803,1135,213,355,24.9945839,121.3412207,1938,568,164
3,桃園市,034319,市立平鎮高中,46,78,0,0,6,17,48,892,821,270,286,24.939725,121.21896,1713,556,147
3,桃園市,034332,市立觀音高中,50,88,0,0,7,11,27,478,385,143,118,25.0147432,121.1327739,863,261,156
3,桃園市,034335,市立新屋高級中等學校,44,84,0,0,5,10,21,296,187,0,0,24.970544,121.1017254,483,0,143
3,桃園市,034347,市立永豐高中,59,132,0,0,2,18,40,699,648,192,201,24.9749506,121.2701309,1347,393,211
3,桃園市,034399,市立大園國際高中,52,64,0,0,3,13,45,644,969,156,328,25.0211,121.2210422,1613,484,132
4,新竹縣,040302,國立竹東高中,38,71,9,4,8,13,48,836,792,254,266,24.732995,121.088225,1628,520,143
4,新竹縣,040304,國立關西高中,24,47,3,1,11,9,27,448,452,161,154,24.788416,121.1855991,900,315,95
4,新竹縣,040308,國立竹北高中,46,92,11,19,6,22,57,1115,835,344,310,24.8369051,121.0041358,1950,654,196
4,新竹縣,041303,私立義民高中,40,63,16,17,2,15,42,1029,944,329,342,24.8391368,121.0040633,1973,671,153
4,新竹縣,041305,私立忠信高中,22,26,6,8,0,2,20,353,235,250,205,24.881078,121.001876,588,455,64
4,新竹縣,041306,私立東泰高中,32,35,3,3,7,15,58,978,566,313,218,24.7115674,121.0983352,1544,531,95
4,新竹縣,041307,私立仰德高中,26,36,8,6,3,13,41,734,579,268,203,24.8815898,121.0051968,1313,471,92
4,新竹縣,044311,縣立六家高級中學,25,60,0,0,0,7,21,412,409,95,157,24.8210147,121.0318342,821,252,92
4,新竹縣,044320,縣立湖口高中,43,113,1,1,7,12,18,311,304,99,100,24.8906561,121.0529741,615,199,177
5,苗栗縣,050303,國立苗栗高中,35,61,1,5,7,13,42,707,741,162,299,24.5594466,120.816554,1448,461,122
5,苗栗縣,050310,國立竹南高中,33,71,4,7,6,19,42,796,753,247,261,24.684093,120.874663,1549,508,140
5,苗栗縣,050314,國立卓蘭高中,41,65,0,0,7,18,33,336,585,104,221,24.312708,120.831961,921,325,131
5,苗栗縣,050315,國立苑裡高中,37,50,2,5,5,13,36,516,685,178,226,24.4479426,120.6560924,1201,404,112
5,苗栗縣,051302,私立君毅高中,42,60,3,3,11,9,43,886,631,340,275,24.7010062,120.8830877,1517,615,128
5,苗栗縣,051305,私立大成高中,12,10,3,9,8,5,30,202,294,60,68,24.6824956,120.9384643,496,128,47
5,苗栗縣,051306,私立建臺高中,41,55,3,7,6,10,26,588,454,232,249,24.5602456,120.8149379,1042,481,122
5,苗栗縣,051307,私立全人實驗高中,6,3,0,0,0,2,3,24,9,7,1,24.3058986,120.8622756,33,8,11
5,苗栗縣,054308,縣立三義高中,23,45,0,0,2,7,12,183,205,39,83,24.4090224,120.7655713,388,122,77
5,苗栗縣,054309,縣立苑裡高中,42,90,0,0,10,9,21,266,315,90,111,24.438008,120.663488,581,201,151
5,苗栗縣,054317,縣立興華高中,36,65,0,0,5,11,18,264,262,82,100,24.6858788,120.9363403,526,182,117
5,苗栗縣,054333,縣立大同高中,16,39,0,0,2,6,13,189,209,62,64,22.678426,120.477654,398,126,63
6,臺中市,060322,國立興大附中,53,47,5,3,3,17,42,854,758,298,254,24.1099288,120.682895,1612,552,128
6,臺中市,060323,國立中科實驗高級中學,28,32,0,0,2,10,15,201,188,71,53,24.2303236,120.6260535,389,124,72
6,臺中市,061306,私立明台高中,45,78,7,10,9,18,58,822,1284,452,630,24.0614589,120.7031172,2106,1082,167
6,臺中市,061309,私立致用高中,45,62,12,5,5,19,68,1508,920,693,487,24.3407676,120.6304738,2428,1180,148
6,臺中市,061310,私立大明高中,54,66,19,8,9,22,49,987,852,600,567,24.116227,120.685708,1839,1167,178
6,臺中市,061311,私立嘉陽高中,20,19,0,0,4,10,47,932,644,450,229,24.2651602,120.5831409,1576,679,53
6,臺中市,061313,私立明道高中,146,199,5,3,10,43,93,2177,2236,747,762,24.1068736,120.6361535,4413,1509,406
6,臺中市,061314,私立僑泰高中,108,130,2,15,12,27,128,2856,2571,1015,999,24.1117897,120.6669624,5427,2014,294
6,臺中市,061315,私立華盛頓高中,38,65,10,1,2,16,24,540,489,184,169,24.1581869,120.74518,1029,353,132
6,臺中市,061316,私立青年高中,59,83,44,52,5,21,79,1624,936,465,373,24.086958,120.693459,2560,838,264
6,臺中市,061317,私立弘文高中,62,73,6,3,14,20,35,782,687,258,247,24.2261308,120.704606,1469,505,178
6,臺中市,061318,私立立人高中,45,80,7,7,5,23,48,1050,1171,346,385,24.1057001,120.691521,2221,731,167
6,臺中市,061319,私立玉山高中,8,12,0,5,2,4,21,241,141,101,94,24.2499848,120.8438855,382,195,31
6,臺中市,061321,私立慈明高中,39,58,0,0,7,27,52,939,929,475,477,24.1052061,120.7272563,1868,952,131
6,臺中市,061322,華德福大地實驗學校,4,10,5,7,2,1,3,19,10,1,0,24.1020885,120.6276741,29,1,29
6,臺中市,063303,市立大甲高中,49,68,0,0,10,16,42,654,772,223,279,24.3419225,120.6217338,1426,502,143
6,臺中市,063305,市立清水高中,42,58,0,0,3,17,42,660,844,230,286,24.2652825,120.5740941,1504,516,120
6,臺中市,063312,市立豐原高中,46,61,4,1,6,16,45,723,882,233,320,24.2558681,120.7414285,1605,553,134
6,臺中市,064308,市立后綜高中,57,103,0,0,9,15,30,421,524,152,198,24.3064604,120.7231399,945,350,184
6,臺中市,064324,市立大里高中,39,71,0,0,8,12,22,374,385,112,144,24.0951235,120.6789632,759,256,130
6,臺中市,064328,市立新社高中,45,84,0,0,3,15,27,441,429,133,174,24.2386141,120.806864,870,307,147
6,臺中市,064336,市立長億高中,45,80,0,0,2,14,24,421,384,119,147,24.1138805,120.7210106,805,266,141
6,臺中市,064342,市立中港高中,52,86,0,0,4,15,21,351,385,126,119,24.2442409,120.5419946,736,245,157
6,臺中市,064350,市立龍津高中,38,69,0,0,6,4,18,196,274,0,0,24.204669,120.521466,470,0,117
7,彰化縣,070301,國立彰化女中,38,61,8,14,4,17,45,0,1734,0,594,24.081169,120.543736,1734,594,142
7,彰化縣,070304,國立員林高中,56,62,0,0,9,15,51,802,1161,233,426,23.9622852,120.5637442,1963,659,142
7,彰化縣,070307,國立彰化高中,75,70,14,9,9,18,63,2322,81,786,23,24.0722391,120.5511591,2403,809,195
7,彰化縣,070316,國立鹿港高中,49,56,5,6,9,15,47,831,742,221,227,24.06098,120.4236821,1573,448,140
7,彰化縣,070319,國立溪湖高中,46,62,0,0,9,15,45,696,967,244,315,23.9690638,120.4866598,1663,559,132
7,彰化縣,071311,私立精誠高中,66,74,2,4,5,14,30,794,612,256,213,24.0731321,120.5272945,1406,469,165
7,彰化縣,071317,私立文興高中,34,54,5,6,3,17,20,381,464,178,243,23.867111,120.5868495,845,421,119
7,彰化縣,071318,財團法人正德高中,21,21,3,8,4,14,24,385,441,150,261,24.0587655,120.5184684,826,411,71
7,彰化縣,074308,縣立彰化藝術高中,42,83,0,0,8,10,28,366,434,133,140,24.078871,120.554266,800,273,143
7,彰化縣,074313,縣立二林高中,52,80,0,0,6,7,15,215,197,83,78,23.8901258,120.359044,412,161,145
7,彰化縣,074323,縣立和美高中,54,92,1,2,3,12,21,292,378,93,134,24.1132428,120.49367,670,227,164
7,彰化縣,074328,縣立田中高中,47,70,0,0,6,10,14,198,173,70,76,23.8555119,120.5887042,371,146,133
7,彰化縣,074339,縣立成功高中,51,66,0,0,2,11,16,206,192,58,75,23.9515136,120.4718336,398,133,130
8,南投縣,080302,國立南投高中,61,56,3,0,14,14,45,777,638,261,238,23.91009,120.6803516,1415,499,148
8,南投縣,080305,國立中興高中,45,54,6,5,3,17,41,638,665,244,203,23.9505197,120.6951144,1303,447,130
8,南投縣,080307,國立竹山高中,41,68,0,0,14,14,42,617,549,165,212,23.7618343,120.6812718,1166,377,137
8,南投縣,080308,國立暨大附中,39,60,3,2,4,14,40,537,662,116,206,23.9717773,120.9460392,1199,322,122
8,南投縣,081311,私立五育高中,9,16,5,5,6,11,15,186,248,113,116,23.8929479,120.6719347,434,229,52
8,南投縣,081312,私立三育高中,8,4,2,2,3,6,3,41,31,18,20,23.9084174,120.9350563,72,38,25
8,南投縣,081313,私立弘明實驗高中,9,12,9,5,9,14,3,50,49,21,15,23.8576862,120.6972649,99,36,58
8,南投縣,081314,私立普台高中,27,31,0,0,9,12,15,288,223,98,71,23.9942691,120.93693,511,169,79
8,南投縣,084309,縣立旭光高中,60,101,0,0,7,9,21,313,358,99,121,23.9795219,120.6945993,671,220,177
9,雲林縣,090305,國立斗六高中,58,54,0,0,9,15,48,739,857,239,321,23.7133968,120.5454533,1596,560,136
9,雲林縣,090306,國立北港高中,31,49,0,0,3,14,32,376,447,119,213,23.577404,120.3044383,823,332,97
9,雲林縣,090315,國立虎尾高中,39,49,0,0,4,16,42,681,766,252,252,23.7098209,120.4420491,1447,504,108
9,雲林縣,091307,私立永年高中,20,22,4,3,4,11,10,219,120,152,79,23.6797617,120.3998417,339,231,64
9,雲林縣,091308,私立正心高中,64,66,1,6,12,12,27,618,551,202,185,23.7150432,120.5282857,1169,387,161
9,雲林縣,091311,私立文生高中,15,14,0,0,4,5,8,140,101,67,42,23.6326997,120.2265183,241,109,38
9,雲林縣,091312,私立巨人高中,6,11,0,0,2,3,15,172,407,45,148,23.5754753,120.289419,579,193,22
9,雲林縣,091316,私立揚子高中,25,34,0,0,3,7,18,397,269,163,120,23.6966464,120.4231492,666,283,69
9,雲林縣,091318,財團法人義峰高中,19,19,7,11,5,9,31,531,386,250,168,23.7596526,120.5934384,917,418,70
9,雲林縣,091319,福智高中,7,39,0,0,4,4,10,132,180,61,60,23.635984,120.523744,312,121,54
9,雲林縣,091320,雲林縣維多利亞實驗高中,14,15,0,0,2,7,6,68,52,11,16,23.679668,120.5525074,120,27,38
9,雲林縣,094301,縣立斗南高中,41,70,0,0,3,11,18,278,271,112,84,23.6818742,120.4758371,549,196,125
9,雲林縣,094307,縣立麥寮高中,51,64,0,0,5,14,15,265,189,109,75,23.7577527,120.2511462,454,184,134
9,雲林縣,094308,縣立古坑華德福實驗高級中學,16,9,3,3,1,0,3,15,14,3,5,23.6306774,120.6154051,29,8,32
9,雲林縣,094326,縣立蔦松藝術高中,17,29,0,0,4,6,6,53,58,0,0,23.5217265,120.2299138,111,0,56
10,嘉義縣,100301,國立東石高中,59,41,2,0,13,12,38,847,384,273,113,23.4646737,120.2516334,1231,386,127
10,嘉義縣,100302,國立新港藝術高中,19,23,3,1,3,10,16,138,198,79,96,23.559895,120.349388,336,175,59
10,嘉義縣,101303,私立同濟高中,12,7,0,0,3,3,8,130,106,49,41,23.604358,120.473369,236,90,25
10,嘉義縣,101304,私立協同高中,52,53,2,2,14,13,24,504,501,169,148,23.5323168,120.4367532,1005,317,136
10,嘉義縣,104319,縣立竹崎高中,47,61,0,0,2,0,18,232,232,64,59,23.5211813,120.5530783,464,123,110
10,嘉義縣,104326,縣立永慶高中,37,33,3,1,2,6,14,175,217,46,65,23.46505,120.294687,392,111,82
11,臺南市,110302,國立新豐高中,38,48,0,0,5,15,37,550,559,162,218,22.9718627,120.295809,1109,380,106
11,臺南市,110308,國立臺南大學附中,47,70,2,7,12,14,48,716,869,251,316,23.0232218,120.2522672,1585,567,152
11,臺南市,110311,國立北門高中,29,41,5,4,7,10,30,488,509,153,172,23.1671481,120.1772896,997,325,96
11,臺南市,110312,國立新營高中,33,55,2,3,6,13,33,392,641,145,205,23.3083164,120.3120353,1033,350,112
11,臺南市,110314,國立後壁高中,32,50,6,3,9,14,30,341,302,144,138,23.3558294,120.3587437,643,282,114
11,臺南市,110315,國立善化高中,32,44,0,0,9,9,30,486,393,166,167,23.129921,120.300794,879,333,94
11,臺南市,110317,國立新化高中,37,48,4,5,4,14,36,507,732,158,271,23.039008,120.3104284,1239,429,112
11,臺南市,110328,國立南科國際實驗高中,34,56,0,5,6,16,15,207,170,75,50,23.1060327,120.2922443,377,125,117
11,臺南市,111313,私立南光高中,32,41,0,0,5,6,23,535,465,181,165,23.2981915,120.3148321,1000,346,84
11,臺南市,111318,私立鳳和高中,6,1,0,0,1,1,2,32,32,45,40,23.2796354,120.326017,64,85,9
11,臺南市,111320,私立港明高中,69,43,7,4,2,11,38,975,647,400,259,23.1189915,120.1952371,1622,659,136
11,臺南市,111321,臺南市興國高中,41,51,0,0,2,13,22,477,388,265,186,23.3128662,120.3223801,865,451,107
11,臺南市,111322,私立明達高中,18,8,3,3,2,6,8,161,139,64,62,23.3105731,120.2746819,300,126,40
11,臺南市,111326,私立新榮高中,11,12,0,0,7,5,19,161,77,101,42,23.2693288,120.3159048,238,143,35
11,臺南市,114306,市立大灣高中,46,116,10,13,7,8,18,401,312,128,114,23.00666,120.2729047,713,242,200
11,臺南市,114307,市立永仁高中,31,76,0,0,5,10,12,194,225,63,72,23.0036078,120.2402968,419,135,122
12,高雄市,120303,國立鳳山高中,52,78,3,5,3,19,54,1149,842,381,303,22.6297556,120.3456278,1991,684,160
12,高雄市,120304,國立岡山高中,42,63,0,0,4,15,45,730,756,229,279,22.7974429,120.2904307,1486,508,124
12,高雄市,120311,國立旗美高中,19,48,0,0,7,11,27,307,410,101,163,22.8839816,120.4944552,717,264,85
12,高雄市,120319,國立鳳新高中,56,85,17,55,6,16,57,1033,1001,339,339,22.6137876,120.3424696,2034,678,235
12,高雄市,121306,財團法人新光高中,5,4,4,7,3,6,17,183,139,40,35,22.6350568,120.3902593,322,75,29
12,高雄市,121307,財團法人普門中學,19,27,14,7,7,6,15,200,133,83,50,22.716617,120.446001,333,133,80
12,高雄市,121318,私立正義高中,10,23,6,6,0,7,10,178,147,93,68,22.6025542,120.3397998,325,161,52
12,高雄市,121320,私立義大國際高中,16,20,12,26,5,6,6,119,113,48,28,22.7283207,120.4055547,232,76,85
12,高雄市,124302,市立文山高中,38,88,0,1,5,12,24,360,395,112,136,22.6484436,120.3535462,755,248,144
12,高雄市,124311,市立林園高中,65,109,0,0,6,13,18,281,294,81,103,22.5137204,120.3945114,575,184,193
12,高雄市,124313,市立仁武高中,53,65,0,0,4,11,21,289,243,72,83,22.7022904,120.3554411,532,155,133
12,高雄市,124322,市立路竹高中,52,95,7,13,4,13,21,307,248,95,113,22.8552779,120.2523546,555,208,184
12,高雄市,124333,市立六龜高中,19,27,0,0,3,4,6,60,48,15,11,22.993343,120.635442,108,26,53
12,高雄市,124340,市立福誠高中,46,101,8,9,6,12,21,351,346,106,131,22.5903176,120.3232778,697,237,182
13,屏東縣,130302,國立屏東女中,37,75,0,0,8,14,48,9,1607,8,556,22.6745474,120.4937461,1616,564,134
13,屏東縣,130305,國立屏東高中,63,65,0,0,9,18,57,1822,56,603,17,22.6865723,120.4876483,1878,620,155
13,屏東縣,130306,國立潮州高中,39,59,0,0,8,13,42,619,822,198,272,22.5495485,120.5452894,1441,470,119
13,屏東縣,130322,國立屏北高中,28,37,0,0,5,10,30,273,503,100,204,22.759382,120.543578,776,304,80
13,屏東縣,131307,財團法人屏榮高中,51,56,7,19,7,8,59,1089,1064,502,521,22.6735412,120.5030639,2153,1023,148
13,屏東縣,131308,私立陸興高中,12,10,9,5,1,7,8,177,102,100,65,22.674615,120.5005095,279,165,44
13,屏東縣,131311,私立美和高中,34,25,0,0,4,9,19,373,232,177,104,22.6006765,120.5600266,605,281,72
13,屏東縣,134304,縣立大同高中,42,84,0,0,1,10,22,222,470,71,157,22.678426,120.477654,692,228,137
13,屏東縣,134321,縣立枋寮高中,40,58,0,0,4,9,13,161,161,53,54,22.3706155,120.5903571,322,107,111
13,屏東縣,134324,縣立東港高中,82,101,0,0,5,7,21,348,326,98,116,22.4648761,120.4553517,674,214,195
13,屏東縣,134334,縣立來義高中,26,30,0,0,2,6,12,98,81,21,18,22.52572,120.6296972,179,39,64
14,臺東縣,140301,國立臺東大學附屬體育高中,21,22,0,0,10,11,9,128,72,52,13,22.7644294,121.075238,200,65,64
14,臺東縣,140302,國立臺東女中,23,44,0,0,3,13,27,11,836,1,314,22.760901,121.15348,847,315,83
14,臺東縣,140303,國立臺東高中,40,41,0,0,5,13,31,876,32,287,8,22.7477668,121.1465661,908,295,99
14,臺東縣,141301,臺東縣均一高中,17,13,0,0,4,13,5,64,58,13,13,22.7703313,121.1261014,122,26,47
14,臺東縣,141307,私立育仁高中,9,13,0,0,0,7,9,61,82,22,42,22.77419,121.092785,143,64,29
14,臺東縣,144322,縣立蘭嶼高中,10,18,0,0,5,5,3,42,16,9,4,22.0498373,121.5118562,58,13,38
15,花蓮縣,150302,國立花蓮女中,38,44,6,6,3,14,33,8,1035,0,363,23.9793987,121.6152496,1043,363,111
15,花蓮縣,150303,國立花蓮高中,41,49,8,20,5,14,37,1153,20,335,15,23.9867344,121.6258141,1173,350,137
15,花蓮縣,150309,國立玉里高中,32,49,0,0,10,11,33,291,233,63,67,23.345486,121.318262,524,130,102
15,花蓮縣,151306,私立海星高中,23,37,9,22,4,9,21,340,470,121,194,24.0073437,121.613781,810,315,104
15,花蓮縣,151307,私立四維高中,37,40,8,6,9,10,33,776,645,344,261,24.0003499,121.5914759,1421,605,110
15,花蓮縣,151312,財團法人慈濟大學附中,40,42,6,6,8,9,15,259,281,89,89,23.999868,121.5741826,540,178,111
15,花蓮縣,154301,花蓮縣立體育高中,11,6,0,0,5,7,6,90,35,26,6,24.0031924,121.5837156,125,32,29
15,花蓮縣,154399,縣立南平中學,2,5,0,0,1,7,2,0,2,0,3,23.7833851,121.4575662,2,3,15
16,澎湖縣,160302,國立馬公高中,49,57,4,17,8,15,48,565,689,216,247,23.5710333,119.5806143,1254,463,150
17,基隆市,170301,國立基隆女中,46,70,1,1,4,20,45,0,1109,0,456,25.1286152,121.7591702,1109,456,142
17,基隆市,170302,國立基隆高中,37,54,12,45,6,17,33,445,134,216,27,25.1075761,121.7328491,579,243,171
17,基隆市,171306,私立二信高中,78,100,9,5,15,23,54,1152,859,503,328,25.143902,121.771516,2011,831,230
17,基隆市,171308,輔大聖心高中,21,22,0,0,2,8,17,297,113,145,65,25.1353145,121.7338675,410,210,53
17,基隆市,173304,市立中山高中,26,58,1,6,6,10,12,135,115,46,43,22.728652,120.2927492,250,89,107
17,基隆市,173306,市立安樂高中,29,57,4,5,1,12,12,210,174,80,54,25.1351392,121.7299807,384,134,108
17,基隆市,173307,市立暖暖高中,17,45,0,0,4,7,12,192,115,91,38,25.1081244,121.737743,307,129,73
17,基隆市,173314,市立八斗高中,26,45,0,0,2,8,12,85,58,42,23,25.140237,121.7882919,143,65,81
18,新竹市,180301,國立科學工業園區實驗高中,41,72,0,0,6,30,22,379,305,141,92,24.777184,121.016432,684,233,149
18,新竹市,180302,國立新竹女中,36,97,3,6,1,23,54,17,1989,6,687,24.8047857,120.9755859,2006,693,166
18,新竹市,180309,國立新竹高中,62,73,32,58,5,20,56,2059,72,695,20,24.795089,120.9804127,2131,715,250
18,新竹市,181305,私立光復高中,82,107,22,24,9,24,111,2431,1940,774,745,24.798387,120.994056,4371,1519,268
18,新竹市,181306,私立曙光女中,24,78,0,0,0,11,24,8,1083,0,372,24.811149,120.9728262,1091,372,113
18,新竹市,181307,私立磐石高中,49,57,5,7,10,12,42,1271,627,406,204,24.8108193,120.9570734,1898,610,140
18,新竹市,181308,私立世界高中,10,24,10,7,3,10,29,313,334,103,169,24.7807043,121.0198068,647,272,64
18,新竹市,183306,市立成德高中,27,76,0,0,5,15,27,562,356,168,109,24.7909191,120.953335,918,277,123
18,新竹市,183307,市立香山高中,33,91,0,0,5,12,26,464,442,158,127,24.785165,120.930349,906,285,141
18,新竹市,183313,市立建功高中,22,100,0,0,1,15,24,512,466,159,165,24.7978951,121.0023113,978,324,138
19,臺中市,191301,私立東大附中,27,48,4,7,4,5,18,392,404,111,145,24.182282,120.6055347,796,256,95
19,臺中市,191302,私立葳格高中,27,48,0,0,6,34,28,429,471,261,225,24.1785854,120.711852,900,486,115
19,臺中市,191305,私立新民高中,112,141,0,0,13,23,132,2900,2922,718,975,24.1586929,120.685906,5822,1693,289
19,臺中市,191308,私立宜寧高中,23,49,15,13,5,13,40,942,684,431,378,24.1938884,120.606577,1626,809,118
19,臺中市,191309,私立明德高中,41,121,13,8,9,20,78,903,1980,344,837,24.120318,120.683671,2883,1181,212
19,臺中市,191311,私立衛道高中,81,81,1,1,12,22,24,718,362,265,95,24.1830032,120.6750442,1080,360,198
19,臺中市,191313,私立曉明女中,34,68,1,11,2,15,18,0,840,0,275,24.168102,120.673388,840,275,131
19,臺中市,191314,私立嶺東高中,65,83,8,13,12,23,78,1753,1360,644,562,24.138096,120.610281,3113,1206,204
19,臺中市,191315,私立磊川華德福實驗教育學校,11,16,0,0,3,7,3,20,21,4,11,24.1804983,120.713242,41,15,37
19,臺中市,193301,市立臺中女中,50,76,5,15,5,18,54,0,2046,0,712,24.136043,120.677765,2046,712,169
19,臺中市,193302,市立臺中一中,99,79,0,0,10,20,75,2791,84,923,29,24.1498345,120.6863244,2875,952,208
19,臺中市,193303,市立忠明高中,36,86,0,0,5,13,27,319,662,123,212,24.1589341,120.6636692,981,335,140
19,臺中市,193313,市立西苑高中,71,128,0,0,5,20,27,484,537,170,186,24.186534,120.64181,1021,356,224
19,臺中市,193315,市立東山高中,72,151,0,0,9,17,30,510,583,154,229,24.1663557,120.712095,1093,383,249
19,臺中市,193316,市立惠文高中,64,103,0,0,5,17,33,674,608,210,211,24.1516147,120.6397871,1282,421,189
19,臺中市,194303,市立臺中二中,72,90,0,0,7,24,69,1688,855,573,272,24.1529906,120.6749422,2543,845,193
19,臺中市,194315,市立文華高中,51,85,5,20,5,24,60,761,1453,256,497,24.1702094,120.6599389,2214,753,190
20,嘉義市,200302,國立嘉義女中,43,62,4,15,6,16,48,0,1666,0,579,23.473657,120.450995,1666,579,146
20,嘉義市,200303,國立嘉義高中,67,85,28,42,7,22,66,2059,146,725,60,23.47709,120.4648722,2205,785,251
20,嘉義市,201304,私立興華高中,34,55,0,0,8,12,33,686,582,347,320,23.4895018,120.4647954,1268,667,109
20,嘉義市,201309,私立仁義高中,5,3,1,4,2,3,9,89,29,39,21,23.4594591,120.4865167,118,60,18
20,嘉義市,201310,私立嘉華高中,22,25,7,2,4,6,15,248,209,134,77,23.4835895,120.4767061,457,211,66
20,嘉義市,201312,私立輔仁高中,41,36,0,0,6,13,19,426,317,190,126,23.460557,120.456993,743,316,96
20,嘉義市,201313,私立宏仁女中,7,16,5,4,3,7,5,4,164,0,129,23.506283,120.445669,168,129,42
20,嘉義市,201314,私立立仁高中,8,7,3,8,1,5,9,140,171,57,78,23.4631749,120.4594794,311,135,32
21,臺南市,210303,國立臺南二中,58,79,4,8,3,19,57,1357,747,494,235,23.0055481,120.212765,2104,729,171
21,臺南市,210305,國立臺南一中,87,64,0,0,4,21,60,2117,59,732,17,22.9942111,120.2158889,2176,749,176
21,臺南市,210306,國立臺南女中,43,86,7,21,7,17,57,16,2060,4,709,22.9872458,120.2065307,2076,713,181
21,臺南市,210309,國立家齊高中,40,86,0,0,6,17,51,386,1408,102,507,22.981624,120.200817,1794,609,149
21,臺南市,211301,私立長榮高中,89,100,7,3,31,21,78,1618,1053,781,584,22.9894128,120.2229561,2671,1365,251
21,臺南市,211302,私立長榮女中,8,26,10,17,6,11,22,172,729,83,432,22.9911165,120.2211482,901,515,78
21,臺南市,211304,財團法人聖功女中,30,59,0,3,2,25,18,0,788,0,318,23.014844,120.221297,788,318,119
21,臺南市,211310,臺南市光華高中,14,56,0,0,1,14,35,348,843,145,354,22.988612,120.21739,1191,499,85
21,臺南市,211314,私立六信高中,14,11,0,0,1,7,25,281,258,109,72,22.9742224,120.202586,539,181,33
21,臺南市,211315,私立瀛海高中,43,35,0,0,3,10,24,605,392,220,138,23.0350309,120.2113593,997,358,91
21,臺南市,211317,私立崑山高中,12,18,11,9,2,12,22,160,161,114,73,23.0110042,120.2263303,321,187,64
21,臺南市,211318,私立德光高中,40,76,7,3,4,28,24,526,572,163,202,22.9798586,120.2214007,1098,365,158
21,臺南市,211320,財團法人慈濟高中,32,55,0,1,7,11,18,295,251,107,94,23.999868,121.5741826,546,201,106
21,臺南市,213303,市立南寧高中,30,44,0,0,4,6,12,187,174,65,68,22.935473,120.186614,361,133,84
21,臺南市,213316,市立土城高中,15,36,5,11,1,8,9,118,135,39,46,23.0574603,120.1505744,253,85,76
30,臺北市,313301,市立西松高中,43,66,2,5,11,13,33,669,402,217,121,25.0553554,121.5671134,1071,338,140
30,臺北市,313302,市立中崙高中,41,102,3,4,7,18,30,552,533,171,184,25.0487115,121.5611909,1085,355,175
30,臺北市,321399,臺北市私立協和祐德高級中學,27,17,11,8,5,5,28,456,103,397,103,25.04252,121.5835426,559,500,73
30,臺北市,323301,市立松山高中,59,98,0,0,1,23,63,1155,1100,378,367,25.0434938,121.5654685,2255,745,181
30,臺北市,323302,市立永春高中,41,84,3,13,4,19,48,771,916,216,291,25.032802,121.5785567,1687,507,164
30,臺北市,330301,國立師大附中,82,136,37,84,12,37,79,1950,910,670,330,25.0336592,121.5404218,2860,1000,388
30,臺北市,331301,私立延平中學,48,65,0,0,8,13,27,799,466,276,189,25.0363216,121.5384679,1265,465,134
30,臺北市,331302,私立金甌女中,21,60,9,5,4,7,31,0,1133,0,577,25.034768,121.5241819,1133,577,106
30,臺北市,331304,私立復興實驗高中,35,44,0,0,7,15,9,232,205,66,68,25.0394418,121.5484403,437,134,101
30,臺北市,333301,市立和平高中,45,115,0,0,9,18,42,799,653,274,200,25.0196314,121.5491522,1452,474,187
30,臺北市,341301,私立中興中學,0,0,0,0,0,0,0,0,0,31,14,25.049844,121.5417566,0,45,0
30,臺北市,341302,私立大同高中,27,24,3,5,8,8,23,606,291,222,149,25.0665289,121.5212887,897,371,75
30,臺北市,343301,市立中山女中,53,121,6,12,4,23,67,0,2400,0,818,25.0485108,121.5372111,2400,818,219
30,臺北市,343302,市立大同高中,52,124,8,20,6,20,48,888,829,221,345,25.0550217,121.5352723,1717,566,230
30,臺北市,343303,市立大直高中,51,96,5,2,6,20,30,542,512,177,163,25.07886,121.543375,1054,340,180
30,臺北市,351301,私立強恕中學,8,12,3,11,6,5,29,309,425,92,122,25.0250348,121.5199538,734,214,45
30,臺北市,353301,市立建國中學,119,102,3,13,14,27,85,3101,0,1076,0,25.0311123,121.5121811,3101,1076,278
30,臺北市,353302,市立成功中學,67,99,4,19,5,19,67,2477,0,793,0,25.0423722,121.5236574,2477,793,213
30,臺北市,353303,市立北一女中,58,117,9,14,5,21,69,0,2515,0,876,25.0385655,121.513098,2515,876,224
30,臺北市,361301,私立靜修女中,12,67,0,6,4,6,19,14,726,0,419,25.0579309,121.515496,740,419,95
30,臺北市,363301,市立明倫高中,47,79,4,4,8,15,48,862,818,209,274,25.0762461,121.5193385,1680,483,157
30,臺北市,363302,市立成淵高中,51,118,0,0,10,23,36,729,569,213,201,25.0614213,121.5185204,1298,414,202
30,臺北市,371301,私立立人高中,0,0,0,0,0,0,0,0,0,1,0,24.1057001,120.691521,0,1,0
30,臺北市,373301,市立華江高中,49,77,2,6,6,15,51,794,988,215,303,25.0279587,121.4971355,1782,518,155
30,臺北市,373302,市立大理高中,46,66,0,0,8,19,27,496,440,134,151,25.0308614,121.4912045,936,285,139
30,臺北市,380301,國立政大附中,25,55,0,0,4,16,18,359,291,88,131,24.9871265,121.5858355,650,219,100
30,臺北市,381301,私立東山高中,67,93,0,0,6,26,38,1064,641,391,236,24.9733741,121.5615447,1705,627,192
30,臺北市,381302,私立滬江高中,26,31,18,7,4,13,30,416,205,207,112,24.9894519,121.5389166,621,319,99
30,臺北市,381303,私立大誠高中,12,5,5,0,2,7,13,146,24,29,17,24.9909268,121.5781913,170,46,31
30,臺北市,381304,私立再興中學,37,57,0,0,7,14,18,437,387,167,119,24.9901829,121.5582292,824,286,115
30,臺北市,381305,私立景文高中,40,51,0,0,8,17,31,617,427,443,277,24.9853665,121.5673971,1044,720,116
30,臺北市,381306,臺北市靜心高中,22,27,0,0,4,13,2,27,30,0,0,24.9988631,121.5467337,57,0,66
30,臺北市,383301,市立景美女中,42,109,4,6,7,20,60,0,2129,0,717,24.9807371,121.5561748,2129,717,188
30,臺北市,383302,市立萬芳高中,49,101,4,7,8,22,33,583,576,155,174,25.0006248,121.5589135,1159,329,191
30,臺北市,393301,市立南港高中,44,108,0,0,9,17,30,543,479,119,183,25.052412,121.595026,1022,302,178
30,臺北市,393302,市立育成高中,46,99,0,0,10,22,60,919,992,251,294,25.0580409,121.6092336,1911,545,177
30,臺北市,401301,私立文德女中,1,7,3,9,1,4,4,0,77,0,84,25.0776217,121.5895146,77,84,25
30,臺北市,401302,私立方濟中學,16,14,3,6,3,5,9,232,89,133,43,25.0773094,121.5905296,321,176,47
30,臺北市,401303,私立達人女中,11,45,3,9,2,11,9,0,338,0,125,25.0812081,121.5876596,338,125,81
30,臺北市,403301,市立內湖高中,50,101,2,16,9,19,61,1062,1056,319,353,25.0783868,121.5866053,2118,672,197
30,臺北市,403302,市立麗山高中,32,51,2,8,6,11,33,612,351,162,145,25.0851252,121.5780273,963,307,110
30,臺北市,403303,市立南湖高中,47,77,2,2,8,20,48,889,799,236,274,25.0664602,121.6105269,1688,510,156
30,臺北市,411301,私立泰北高中,33,43,16,11,4,11,32,442,417,240,241,25.097375,121.533898,859,481,118
30,臺北市,411302,私立衛理女中,19,58,10,4,3,24,15,0,512,0,188,25.1017466,121.5523894,512,188,118
30,臺北市,411303,私立華興中學,32,29,0,0,9,0,6,147,95,52,38,25.1050855,121.5385223,242,90,70
30,臺北市,413301,市立陽明高中,42,105,5,11,6,24,39,680,670,211,232,25.0922121,121.5172424,1350,443,193
30,臺北市,413302,市立百齡高中,48,120,1,15,10,17,27,493,444,152,134,25.0870549,121.5229998,937,286,211
30,臺北市,421301,私立薇閣高中,59,76,0,0,6,9,24,569,499,151,171,25.1395247,121.5039712,1068,322,150
30,臺北市,421302,臺北市幼華高中,11,22,10,12,1,6,17,297,179,99,91,25.1334354,121.4968537,476,190,62
30,臺北市,421303,臺北市私立奎山實驗高級中學,10,11,0,0,0,3,3,56,50,17,16,25.112998,121.5223028,106,33,24
30,臺北市,423301,市立復興高中,70,107,3,8,6,23,69,937,1169,210,380,25.143626,121.501768,2106,590,217
30,臺北市,423302,市立中正高中,67,111,2,10,10,19,69,1325,1083,335,355,25.1041727,121.5166212,2408,690,219
50,高雄市,521301,私立明誠高中,38,33,3,7,8,19,18,280,259,147,159,22.666246,120.292014,539,306,108
50,高雄市,521303,私立大榮高中,33,18,13,2,6,8,30,677,36,355,17,22.6535429,120.2801989,713,372,80
50,高雄市,523301,市立鼓山高中,35,73,3,5,6,12,27,332,337,98,116,22.6520055,120.2747089,669,214,134
50,高雄市,533301,市立左營高中,41,85,10,20,2,16,54,726,914,196,332,22.6933029,120.2961624,1640,528,174
50,高雄市,533302,市立新莊高中,33,77,7,6,1,12,45,865,742,297,258,22.6813675,120.3175826,1607,555,136
50,高雄市,540301,國立中山大學附屬國光高中,32,49,13,12,7,10,18,341,321,112,117,22.7082782,120.3050243,662,229,123
50,高雄市,543301,市立中山高中,28,62,4,5,2,12,42,651,805,234,278,22.728652,120.2927492,1456,512,113
50,高雄市,543302,市立楠梓高中,31,47,2,1,3,9,30,427,450,99,153,22.7439985,120.3316666,877,252,93
50,高雄市,551301,私立立志高中,68,61,32,11,16,17,97,1827,736,900,349,22.6533576,120.3264762,2563,1249,205
50,高雄市,553301,市立高雄中學,90,82,21,59,5,18,72,2629,116,859,33,22.6383194,120.2980028,2745,892,275
50,高雄市,553302,市立三民高中,33,53,0,3,4,12,36,611,604,184,199,25.0868693,121.4737065,1215,383,105
50,高雄市,563301,市立新興高中,37,71,0,2,2,15,20,338,341,90,118,22.6243825,120.3041272,679,208,127
50,高雄市,573301,市立高雄女中,45,102,5,8,3,18,63,0,2383,0,825,22.6212858,120.2928418,2383,825,181
50,高雄市,580301,國立高師大附中,24,61,10,13,2,17,24,603,265,193,86,22.6260694,120.3222549,868,279,127
50,高雄市,581301,私立復華高中,30,50,7,4,3,14,42,556,737,260,348,22.621182,120.313424,1293,608,108
50,高雄市,581302,天主教道明中學,71,92,3,5,5,19,40,930,965,383,437,22.6338273,120.3228343,1895,820,195
50,高雄市,583301,市立中正高中,39,105,3,4,4,15,33,566,558,187,200,25.1041727,121.5166212,1124,387,170
50,高雄市,593301,市立前鎮高中,49,51,4,4,4,13,45,771,817,232,272,22.5879884,120.3192383,1588,504,125
50,高雄市,593302,市立瑞祥高中,59,123,2,9,7,17,27,506,431,172,139,22.6016779,120.3248846,937,311,217
50,高雄市,613301,市立小港高中,40,69,0,0,5,10,45,665,789,208,266,22.5644955,120.3567887,1454,474,124
71,金門縣,710301,國立金門高中,42,35,0,0,7,13,30,466,482,137,137,24.4349442,118.3137113,948,274,97
72,連江縣,720301,國立馬祖高中,15,19,0,2,9,7,12,147,110,38,38,26.1544475,119.9498791,257,76,52
1,新北市,011405,私立樹人家商,30,95,2,8,3,17,63,979,1589,254,671,24.994468,121.4192578,2568,925,155
1,新北市,011407,私立復興商工,55,52,33,25,7,16,78,1122,2269,419,863,25.003454,121.518399,3391,1282,188
1,新北市,011408,私立南強工商,41,27,33,25,8,14,49,737,532,360,239,24.9808412,121.5448562,1269,599,148
1,新北市,011413,私立穀保家商,24,63,21,5,2,14,45,867,1065,287,404,25.0693157,121.4710759,1932,691,129
1,新北市,011419,私立開明工商,12,13,13,12,4,6,27,484,227,167,98,24.9800534,121.5462266,711,265,60
1,新北市,011420,私立智光商工,37,50,6,6,5,20,49,1073,536,446,258,24.9956844,121.5142997,1609,704,124
1,新北市,011421,私立清傳高商,5,20,3,6,4,7,10,123,185,91,116,25.0520106,121.4768683,308,207,45
1,新北市,011426,私立能仁家商,22,37,37,47,4,13,71,941,1274,423,693,24.9579932,121.5401745,2215,1116,160
1,新北市,011427,私立豫章工商,16,29,17,15,5,12,35,802,349,365,157,24.9972245,121.4590085,1151,522,94
1,新北市,011431,私立莊敬工家,89,73,18,10,48,57,107,2132,2463,380,674,24.98555,121.5320166,4595,1054,295
1,新北市,011432,私立中華商海,11,1,7,0,4,3,9,80,17,62,6,25.1774912,121.6860542,97,68,26
1,新北市,013402,市立瑞芳高工,72,58,6,2,16,14,55,972,252,288,121,25.1107886,121.8036958,1224,409,168
1,新北市,013430,市立三重商工,83,98,28,21,15,19,79,1607,774,463,286,25.0693564,121.481217,2381,749,264
1,新北市,013433,市立新北高工,110,90,0,0,12,21,92,2300,526,735,168,24.9824,121.4513028,2826,903,233
1,新北市,013434,市立淡水商工,80,116,2,1,14,18,84,1334,1026,369,351,25.1873489,121.454254,2360,720,231
1,新北市,014439,市立鶯歌工商,64,100,2,2,12,16,63,926,1002,182,320,24.9393742,121.3351073,1928,502,196
1,新北市,014468,市立樟樹國際實中,37,77,0,0,3,9,17,144,222,0,0,25.0659397,121.6398933,366,0,126
2,宜蘭縣,020403,國立宜蘭高商,45,78,0,0,10,14,49,799,758,247,285,24.7552719,121.7654572,1557,532,147
2,宜蘭縣,020404,國立羅東高商,48,65,1,2,5,16,48,652,839,164,254,24.6726722,121.756686,1491,418,137
2,宜蘭縣,020405,國立蘇澳海事,42,34,0,0,15,13,35,492,212,209,72,24.594231,121.8445872,704,281,104
2,宜蘭縣,020407,國立羅東高工,83,40,17,4,15,19,45,1366,122,433,31,24.6704012,121.7512832,1488,464,178
2,宜蘭縣,020409,國立頭城家商,36,68,0,0,6,15,46,520,556,112,188,24.8513546,121.8160472,1076,300,125
3,桃園市,030403,國立北科大附屬桃園農工,101,82,16,15,21,20,82,2187,364,677,121,24.9952277,121.3206408,2551,798,255
3,桃園市,031414,私立成功工商,36,34,29,16,8,23,59,1086,570,342,170,24.9888384,121.3411664,1656,512,146
3,桃園市,031415,私立方曙商工,20,17,6,2,7,6,21,168,47,140,47,24.8579318,121.2008338,215,187,58
3,桃園市,031421,私立永平工商,63,92,19,15,14,15,127,2385,1784,921,825,24.919795,121.17523,4169,1746,218
3,桃園市,033407,市立中壢高商,50,102,2,5,8,15,60,742,1154,235,412,24.962135,121.214913,1896,647,182
3,桃園市,033408,市立中壢家商,18,59,0,0,5,17,29,169,767,0,304,24.962135,121.214913,936,304,99
4,新竹縣,041401,私立內思高工,39,27,11,6,4,13,28,918,170,368,111,24.828444,121.0824601,1088,479,100
5,苗栗縣,050401,國立大湖農工,52,28,0,0,12,13,29,583,214,199,105,24.4211342,120.8612213,797,304,105
5,苗栗縣,050404,國立苗栗農工,78,68,0,0,17,22,54,1381,498,416,155,24.5564627,120.834069,1879,571,185
5,苗栗縣,050407,國立苗栗高商,27,54,0,0,9,10,37,367,657,81,272,24.5570318,120.8152979,1024,353,100
5,苗栗縣,051408,私立中興商工,19,21,3,2,8,10,28,500,359,209,131,24.6879837,120.8725771,859,340,63
5,苗栗縣,051411,私立育民工家,13,11,0,5,5,9,23,241,92,107,39,24.5380764,120.8130589,333,146,43
5,苗栗縣,051412,私立賢德工商,4,0,0,0,1,3,3,30,2,34,6,24.4754734,120.6753088,32,40,8
5,苗栗縣,051413,私立龍德家商,9,8,0,0,3,3,16,192,196,63,98,24.4286716,120.6439174,388,161,23
6,臺中市,063401,市立豐原高商,45,105,0,0,8,18,61,611,1059,178,374,24.245781,120.7129446,1670,552,176
6,臺中市,063402,市立大甲高工,76,43,0,0,9,22,48,1153,210,350,70,24.3465387,120.6399356,1363,420,150
6,臺中市,063404,市立東勢高工,98,62,0,0,19,17,63,1361,344,460,129,24.2423422,120.8343503,1705,589,196
6,臺中市,063407,市立沙鹿高工,92,64,6,5,19,20,70,1567,509,494,159,24.2386696,120.565676,2076,653,206
6,臺中市,063408,市立霧峰農工,61,48,0,0,11,18,50,1157,256,377,86,24.0731392,120.6998281,1413,463,138
7,彰化縣,070401,國立彰師附工,112,62,0,0,20,19,71,2117,268,671,93,24.0825769,120.5559702,2385,764,213
7,彰化縣,070402,國立永靖高工,63,41,0,0,15,14,37,998,237,315,68,23.9261111,120.5455556,1235,383,133
7,彰化縣,070403,國立二林工商,65,63,8,2,15,11,57,965,524,300,201,23.9011139,120.3774756,1489,501,164
7,彰化縣,070405,國立秀水高工,67,41,66,25,11,20,60,1599,279,539,119,24.0344699,120.499007,1878,658,230
7,彰化縣,070406,國立彰化高商,46,111,0,0,11,13,65,633,1567,180,588,24.0729394,120.5531255,2200,768,181
7,彰化縣,070408,國立員林農工,52,73,0,0,13,19,51,975,630,314,205,23.9545613,120.5818258,1605,519,157
7,彰化縣,070409,國立員林崇實高工,62,38,0,0,14,16,42,1037,239,366,78,23.9611258,120.5748453,1276,444,130
7,彰化縣,070410,國立員林家商,29,76,0,7,7,16,47,247,1140,89,403,23.9503771,120.576024,1387,492,135
7,彰化縣,070415,國立北斗家商,43,70,10,18,6,12,54,432,1237,120,388,23.8783142,120.5224644,1669,508,159
7,彰化縣,071413,私立大慶商工,23,24,17,11,6,22,48,855,431,417,195,23.9481636,120.6010439,1286,612,103
7,彰化縣,071414,私立達德商工,59,90,28,18,9,24,92,2123,1660,1074,761,23.852614,120.608405,3783,1835,228
8,南投縣,080401,國立仁愛高農,20,29,0,0,9,10,18,145,98,62,51,24.021123,121.133602,243,113,68
8,南投縣,080403,國立埔里高工,64,42,3,2,10,19,39,733,200,242,63,23.9719852,120.9778465,933,305,140
8,南投縣,080404,國立南投高商,31,64,3,2,5,18,38,362,532,123,201,23.9035545,120.6845134,894,324,123
8,南投縣,080406,國立草屯商工,57,74,2,5,15,18,52,679,697,238,249,23.9952977,120.6657122,1376,487,171
8,南投縣,080410,國立水里商工,32,45,0,0,11,12,36,518,361,178,166,23.8050576,120.8531811,879,344,100
8,南投縣,081409,私立同德家商,33,42,10,13,6,17,50,954,769,303,304,23.99842,120.695346,1723,607,121
9,雲林縣,090401,國立虎尾農工,57,46,0,0,16,13,43,958,293,314,127,23.7148646,120.4365681,1251,441,132
9,雲林縣,090402,國立西螺農工,66,64,12,5,15,15,47,1223,363,380,129,23.7945462,120.4683819,1586,509,177
9,雲林縣,090403,國立斗六家商,30,47,8,10,3,19,33,311,715,119,242,23.7073983,120.5468819,1026,361,117
9,雲林縣,090404,國立北港農工,50,27,0,0,10,14,30,779,132,276,52,23.5794171,120.3078728,911,328,101
9,雲林縣,090413,國立土庫商工,42,41,0,0,7,15,31,375,601,121,203,23.6724499,120.3877409,976,324,105
9,雲林縣,091410,私立大成商工,34,23,0,0,5,9,42,843,434,554,311,23.71066,120.4454154,1277,865,71
9,雲林縣,091414,私立大德工商,26,14,1,1,2,6,27,389,190,148,78,23.6849601,120.472107,579,226,50
10,嘉義縣,100402,國立民雄農工,70,37,2,2,9,19,39,911,157,316,63,23.5390792,120.4262305,1068,379,139
10,嘉義縣,101405,私立協志工商,53,38,20,13,7,7,73,1268,923,571,426,23.5492506,120.4309573,2191,997,138
10,嘉義縣,101406,私立萬能工商,34,29,0,0,6,9,34,952,565,365,210,23.4310788,120.3909258,1517,575,78
10,嘉義縣,101407,私立弘德工商,3,0,0,0,0,0,1,10,9,25,18,23.4502838,120.2278326,19,43,3
11,臺南市,110401,國立新化高工,54,46,4,1,12,15,39,986,210,311,55,23.0382113,120.3186639,1196,366,132
11,臺南市,110403,國立白河商工,42,33,3,3,7,15,30,325,113,112,47,23.353023,120.41629,438,159,103
11,臺南市,110404,國立北門農工,76,66,0,0,14,18,54,1173,427,335,154,23.1760031,120.1808703,1600,489,174
11,臺南市,110405,國立曾文家商,23,52,4,7,7,11,30,219,711,66,255,23.179107,120.2458479,930,321,104
11,臺南市,110406,國立新營高工,78,40,13,4,14,17,46,1023,280,288,87,23.3132131,120.3172437,1303,375,166
11,臺南市,110407,國立玉井工商,39,34,0,0,9,11,28,387,202,155,79,23.1200355,120.4598153,589,234,93
11,臺南市,110409,國立臺南高工,137,77,11,9,25,22,84,2201,334,746,122,23.014539,120.2336054,2535,868,281
11,臺南市,110410,國立曾文農工,61,72,2,3,15,21,50,799,307,291,146,23.1871927,120.2631909,1106,437,174
11,臺南市,111419,私立陽明工商,23,9,0,0,5,8,26,332,143,155,84,23.1920689,120.3287761,475,239,45
11,臺南市,111427,私立育德工家,19,19,5,4,2,9,25,364,326,181,169,23.3161758,120.3118299,690,350,58
12,高雄市,120401,國立旗山農工,55,46,0,0,16,15,38,688,228,241,91,22.900965,120.48276,916,332,132
12,高雄市,120402,國立岡山農工,89,70,4,10,14,24,65,1361,390,386,177,22.8021759,120.2897251,1751,563,211
12,高雄市,120409,國立鳳山商工,74,76,0,0,14,20,77,1074,1105,260,405,22.634032,120.3579315,2179,665,184
12,高雄市,121405,私立中山工商,153,201,11,2,15,44,188,5424,3332,2007,1165,22.600589,120.393324,8756,3172,426
12,高雄市,121410,私立旗美商工,6,2,6,1,1,4,9,71,46,42,18,22.884854,120.5195241,117,60,20
12,高雄市,121413,私立高英工商,48,34,0,0,8,20,62,1222,589,467,210,22.5941731,120.3999596,1811,677,110
12,高雄市,121415,私立華德工家,14,12,6,3,6,2,30,315,203,77,59,22.9074481,120.1811627,518,136,43
12,高雄市,121417,私立高苑工商,39,34,26,15,7,16,62,1232,465,436,156,22.758928,120.2909505,1697,592,137
13,屏東縣,130401,國立內埔農工,53,41,0,0,15,15,34,562,217,172,81,22.707455,120.640759,779,253,124
13,屏東縣,130403,國立屏東高工,105,69,0,0,21,16,68,1565,274,451,111,22.663264,120.4866854,1839,562,211
13,屏東縣,130404,國立佳冬高農,39,59,0,0,10,16,42,574,395,186,134,22.4128213,120.5639292,969,320,124
13,屏東縣,130410,國立東港海事,44,51,9,5,13,15,38,791,402,242,138,22.4652659,120.4419585,1193,380,137
13,屏東縣,130417,國立恆春工商,37,51,0,0,8,14,34,446,306,115,95,21.9927817,120.7468812,752,210,110
13,屏東縣,131409,私立民生家商,14,22,2,3,1,12,32,433,418,151,166,22.6587044,120.5138436,851,317,54
13,屏東縣,131416,私立華洲工家,0,0,0,0,0,0,0,0,0,32,15,22.6549501,120.4993567,0,47,0
13,屏東縣,131418,私立日新工商,5,9,2,4,1,11,14,165,108,74,34,22.556566,120.5362275,273,108,32
14,臺東縣,140404,國立關山工商,30,27,0,0,9,11,21,181,100,38,37,23.0474168,121.1590111,281,75,77
14,臺東縣,140405,國立臺東高商,35,62,0,0,3,15,36,424,622,86,201,22.7573451,121.1448649,1046,287,115
14,臺東縣,140408,國立成功商水,22,13,0,0,6,10,12,127,44,29,18,23.1059648,121.3824325,171,47,51
14,臺東縣,141406,私立公東高工,26,27,4,5,15,19,32,627,329,220,97,22.767126,121.1350105,956,317,96
15,花蓮縣,150401,國立花蓮高農,46,45,0,0,12,16,35,421,326,105,117,23.984087,121.5991057,747,222,119
15,花蓮縣,150404,國立花蓮高工,86,54,0,0,18,16,47,954,158,277,51,23.9986012,121.6205213,1112,328,174
15,花蓮縣,150405,國立花蓮高商,30,59,0,0,3,19,35,348,666,89,226,23.9863576,121.6022768,1014,315,111
15,花蓮縣,150411,國立光復商工,24,19,0,0,9,8,16,143,91,40,34,23.66717,121.427342,234,74,60
15,花蓮縣,151410,花蓮縣上騰工商,15,11,3,2,6,4,27,264,174,49,44,23.9720191,121.5588648,438,93,41
16,澎湖縣,160401,國立澎湖海事水產,57,49,0,0,17,18,43,655,344,206,130,23.5702986,119.5653356,999,336,141
17,基隆市,170403,國立基隆海事,54,62,0,0,16,16,48,802,347,187,112,25.147706,121.771736,1149,299,148
17,基隆市,170404,國立基隆商工,67,85,9,2,12,19,64,922,778,279,286,25.0941889,121.7173003,1700,565,194
17,基隆市,171405,私立光隆家商,11,12,14,18,2,3,27,200,372,133,246,25.129899,121.749759,572,379,60
17,基隆市,171407,私立培德工家,9,9,7,5,2,5,12,125,60,50,33,25.1298359,121.771327,185,83,37
18,新竹市,180403,國立新竹高商,24,78,5,12,4,17,47,548,1066,176,382,24.7968761,120.986653,1614,558,140
18,新竹市,180404,國立新竹高工,59,73,0,0,10,22,51,1242,366,380,151,24.8093963,120.9829614,1608,531,164
19,臺中市,190406,國立興大附農,50,110,12,15,14,17,79,1161,1133,363,438,24.1286217,120.6851031,2294,801,218
19,臺中市,191412,財團法人光華高工,24,13,5,9,5,11,24,458,56,401,62,24.1380353,120.7364363,514,463,67
19,臺中市,193404,市立臺中家商,51,124,0,0,9,18,80,575,1705,184,591,24.133498,120.684587,2280,775,202
19,臺中市,193407,市立臺中高工,158,102,3,2,28,31,116,3150,494,974,157,24.1133614,120.6614906,3644,1131,324
20,嘉義市,200401,國立華南高商,39,69,0,0,5,15,42,523,850,173,308,23.4784199,120.4592511,1373,481,128
20,嘉義市,200405,國立嘉義高工,148,69,0,0,22,22,95,2119,657,711,236,23.4713743,120.464588,2776,947,261
20,嘉義市,200406,國立嘉義高商,40,72,5,9,2,19,44,449,988,164,328,23.4824119,120.4624409,1437,492,147
20,嘉義市,200407,國立嘉義家職,18,80,0,0,7,13,42,231,942,46,353,23.4716168,120.4587285,1173,399,118
20,嘉義市,201408,私立東吳工家,54,68,10,11,11,13,84,1339,1690,463,653,23.4688064,120.460471,3029,1116,167
21,臺南市,210408,國立臺南高商,51,98,0,0,3,19,64,588,1364,200,456,22.9812227,120.2023948,1952,656,171
21,臺南市,210416,國立臺南海事,46,36,15,6,10,11,33,726,276,245,107,22.9936178,120.1516513,1002,352,124
21,臺南市,211407,私立南英商工,30,43,22,11,7,20,44,818,334,418,175,22.9861239,120.1996235,1152,593,133
21,臺南市,211412,私立亞洲餐旅,16,20,7,4,5,8,24,446,356,205,172,22.9749246,120.2029425,802,377,60
21,臺南市,211419,私立慈幼工商,36,19,11,4,13,12,33,817,210,378,60,22.9893311,120.2397489,1027,438,95
30,臺北市,311401,私立育達家商,41,100,47,48,1,16,94,1736,2346,864,1374,25.0496313,121.5543849,4082,2238,253
30,臺北市,323401,市立松山家商,42,110,3,3,6,23,57,631,1154,183,382,25.0350498,121.5806133,1785,565,187
30,臺北市,323402,市立松山工農,110,82,9,10,16,30,66,1893,427,524,135,25.039982,121.572258,2320,659,257
30,臺北市,331402,私立東方工商,4,12,8,6,2,6,13,90,139,45,57,25.0322561,121.5514468,229,102,38
30,臺北市,331403,私立喬治工商,6,13,2,6,6,8,21,96,272,42,71,25.0259066,121.5545048,368,113,41
30,臺北市,331404,私立開平餐飲,39,34,0,2,2,9,32,611,402,249,152,25.0285456,121.5423269,1013,401,86
30,臺北市,333401,市立大安高工,155,121,17,6,37,28,101,2749,452,865,156,25.0320189,121.5430425,3201,1021,364
30,臺北市,341402,私立稻江護家,12,50,1,14,6,20,32,0,1063,0,541,25.0655224,121.5288056,1063,541,103
30,臺北市,351402,私立開南商工,26,22,0,0,9,15,37,752,198,369,72,25.0424386,121.5218475,950,441,72
30,臺北市,361401,私立稻江高商,14,30,0,0,2,16,28,449,448,177,243,25.0643302,121.5119253,897,420,62
30,臺北市,383401,市立木柵高工,91,81,8,2,17,25,58,1572,290,433,102,24.9968638,121.5726322,1862,535,224
30,臺北市,393401,市立南港高工,107,91,0,0,38,24,69,1913,291,547,98,25.0563397,121.6072921,2204,645,260
30,臺北市,403401,市立內湖高工,91,76,0,0,14,24,58,1629,298,432,97,25.0794378,121.5753706,1927,529,205
30,臺北市,411401,私立華岡藝校,13,19,49,62,2,2,18,176,590,52,190,25.1371929,121.5491247,766,242,147
30,臺北市,413401,市立士林高商,62,142,3,12,11,24,82,846,1520,218,540,25.0945436,121.5160767,2366,758,254
30,臺北市,421404,私立惇敘工商,27,13,3,2,4,5,23,475,35,254,13,25.1446525,121.5271635,510,267,54
50,高雄市,533401,市立海青工商,79,92,2,2,19,18,64,989,918,325,360,22.6752655,120.284936,1907,685,212
50,高雄市,533402,市立三民家商,48,98,0,0,1,22,54,465,1243,154,454,22.666946,120.3011952,1708,608,169
50,高雄市,551402,私立樹德家商,50,130,31,45,10,28,143,1536,3218,624,1319,22.643005,120.32803,4754,1943,294
50,高雄市,553401,市立高雄高工,138,92,1,3,19,21,86,2377,386,816,133,22.6503468,120.3264388,2763,949,274
50,高雄市,563401,市立高雄高商,41,109,2,2,4,16,60,529,1356,163,467,22.625573,120.309023,1885,630,174
50,高雄市,581401,私立國際商工,1,3,11,4,1,2,7,61,98,22,1,22.6212347,120.326302,159,23,22
50,高雄市,581402,私立三信家商,28,61,32,35,3,13,92,1309,1423,377,605,22.622051,120.3287805,2732,982,172
50,高雄市,593401,市立中正高工,108,74,3,1,11,26,75,1892,294,626,109,22.6107875,120.3175699,2186,735,223
50,高雄市,610405,國立高餐大附屬餐旅中學,12,29,0,0,3,5,9,67,165,24,55,22.566209,120.371733,232,79,49
50,高雄市,611401,私立高鳳工家,4,3,1,0,1,4,9,91,61,30,13,22.5765029,120.3769522,152,43,13
71,金門縣,710401,國立金門農工,51,32,0,0,16,14,39,599,399,161,130,24.441624,118.423344,998,291,113
30,臺北市,351B09,私立南華高中進修學校,4,16,0,0,3,10,25,373,357,209,202,25.0156175,121.5311921,730,411,33
30,臺北市,361B09,私立志仁中學進修學校,7,11,26,33,1,6,42,740,714,312,297,25.0522051,121.5188456,1454,609,84
1,新北市,011C71,私立光華高商進修學校,5,8,5,5,1,4,15,229,207,86,86,25.0030663,121.4548612,436,172,28
21,臺南市,210C01,國立成功大學附設高工進修學校,21,15,10,4,2,6,24,191,49,53,21,22.9991111,120.2158342,240,74,58
7,彰化縣,070F01,國立和美實驗學校,0,0,0,0,0,0,15,194,208,59,68,24.105286,120.4914278,402,127,0
11,臺南市,110F01,國立臺南大學附屬啟聰學校,0,0,0,0,0,0,1,3,1,0,0,23.0391523,120.318246,4,0,0
50,高雄市,543F01,市立楠梓特殊學校,0,0,0,0,0,0,3,0,14,0,0,22.7283615,120.3133528,14,0,0
7,彰化縣,070G92,國立二林工商進校分校,0,0,9,5,0,0,3,33,0,9,0,23.9011139,120.3774756,33,9,14
11,臺南市,111G91,私立樹德高中進修學校,0,0,13,1,0,0,3,88,0,27,0,22.643005,120.32803,88,27,14
15,花蓮縣,151G91,私立正德高中進修學校,0,0,27,2,0,0,3,70,0,21,0,24.0587655,120.5184684,70,21,29
3,桃園市,03C301,誠正中學桃園分校,0,0,0,0,0,0,13,176,0,0,0,24.8663014,120.980387,176,0,0
4,新竹縣,04C301,誠正中學,0,0,0,0,0,0,5,88,0,0,0,24.8663014,120.980387,88,0,0
7,彰化縣,07C301,誠正中學彰化分校,0,0,0,0,0,0,14,128,75,0,0,23.8768466,120.6077288,203,0,0
12,高雄市,12C301,明陽中學,0,0,0,0,0,0,4,39,1,23,2,22.7612808,120.3726291,40,25,0
